{\rtf1\ansi\ansicpg936\cocoartf1265\cocoasubrtf210
{\fonttbl\f0\fswiss\fcharset0 Helvetica;}
{\colortbl;\red255\green255\blue255;}
\paperw11900\paperh16840\margl1440\margr1440\vieww12300\viewh9900\viewkind0
\pard\tx566\tx1133\tx1700\tx2267\tx2834\tx3401\tx3968\tx4535\tx5102\tx5669\tx6236\tx6803\pardirnatural

\f0\fs24 \cf0 MACAW: Media access protocol for wireless lans\
ViBE: A Compressed Video Database Structured for Active Browsing and Search\
SIS: A System for Sequential Circuit Synthesis\
SEAD: Secure Efficient Distance Vector Routing for Mobile Wireless Ad Hoc Networks\
gSpan: Graph-Based Substructure Pattern Mining\
HEAR: An Hybrid Episodic-Abstract speech Recognizer\
CUTE: Constrained and unconstrained testing environment\
OdeFS: A File System Interface to an Object-Oriented Database\
IMEM: An Intelligent Memory for Bump- and Reflection-Mapping\
BASS: Bayesian Analyzer of Event Sequences\
WHIRL: A Word-based Information Representation Language\
MUSE: A Musical Data Sonification Toolkit\
PHENICX: Performances as Highly Enriched aNd Interactive Concert Experiences\
Cmc: A pragmatic approach to model checking real code\
Carisma: context-aware reflective middleware system for mobile applications\
FPOP: footprinting functional pockets of proteins by comparative spatial patterns\
PRO: A Profile-based Routing Protocol for Pocket Switched Networks\
SECTOR: secure tracking of node encounters in multi-hop wireless networks\
TVDc: Managing Security in the Trusted Virtual Datacenter\
eCryptfs: An Enterprise-class Cryptographic Filesystem for Linux\
SPRNG: A Scalable Library for Pseudorandom Number Generation\
ARC: A Self-Tuning, Low Overhead Replacement Cache\
STRIPE: Supervised TeleRobotics Using Incremental Polygonal Earth Geometry\
ADIC: An Extensible Automatic Differentiation Tool for ANSI-C\
APPLAUS: A Privacy-Preserving Location Proof Updating System for Location-based Services\
NuSMV: A new symbolic model verifier\
REAPER: A Reflexive Architecture for Perceptive Agents\
MICE: A Flexible Testbed for Intelligent Coordination Experiments\
REGRET: A reputation model for gregarious societies\
Co-OPR: Design and Evaluation of Collaborative Sensemaking and Planning Tools for Personnel Recovery\
wEBMT: Developing and Validating an Example-Based Machine Translation System using the World Wide WebURSA: Ubiquitous and Robust Access Control for Mobile Ad-Hoc Networks\
SCAN: Self-Organized Network-Layer Security in Mobile Ad Hoc Networks\
Steps: A simulated, tutorable physics student\
Microtrex: Micro-Telerobotic Flight Experiment\
COPS: Large-Scale Nonlinearly Constrained Optimization Problems\
OMNI: OpenFlow MaNagement Infrastructure\
ToMaTo: A Trustworthy Code Mashup Development Tool\
XSIL: Extensible Scientific Interchange Language\
DTLSR: Delay Tolerant Routing for Developing Regions \
BUFFALO: Bloom Filter Forwarding Architecture for Large Organizations\
CAMEL: Concept Annotated iMagE Libraries\
MOGAC: A Multiobjective Genetic Algorithm for Hardware-Software Co-Synthesis of Distributed Embedded Systems\
CARMA: A Case-Based Range Management Advisor\
NIMFA: A Python Library for Nonnegative Matrix Factorization\
KNIFE: Kernel Iterative Feature Extraction\
MCP: A Protocol For Coordination and Temporal Synchronization in Multimedia Collaborative Applications\
DVB-H: Digital Broadcast Services to Handheld Devices\
HillSIM: A Hierarchical Bench Logic Simulator for Zero Delay Combinational Circuits\
RUGGED: RoUting on finGerprint Gradients in sEnsor Networks\
BDS: A BDD-Based Logic Optimization System\
Desks: Direction-aware spatial keyword search\
TALplanner: A temporal logic based forward chaining planner\
MACH: My Automated Conversation coacH\
\
}